NO ./textures/north.xpm
SO ./textures/south.xpm
WE ./textures/west.xpm
EA ./textures/east.xpm
DO ./textures/door.xpm

F 220,100,0
C 225,30,0


        1111111111111111111111111        
        1000000000110000000000001 111111     
        10110000011100000000N0001 100001
        1001000000D00000000000001 100001
111111111011000001110000000000001 111111
100000000011000001111111111111111
1111d111111111011100000010001
11110111111111011101010010001
11000000110101011100000010001
10000000000000001100000000001
10000000000000001101010010001
1100000111010101111101111000111
11110111 1110101 101111010001
11111111 1111111 111111111111