
SO ./textures/south.xpm
WE ./textures/west.xpm
EA ./textures/east.xpm
DO ./textures/door.xpm
NO ./textures/north.xpm
F                                   0,0,0
C 225,30,0


111111111111
100000000011
100000000001
111111111111
10N000000001
111111111111
11111      1
111111111111