WE ./textures/west.xpm
NO ./textures/north.xpm
SO ./textures/south.xpm
EA ./textures/east.xpm
F 220,110,0
C 225,30,0

1111111
1111111
1N00111
111111
1111111